12.ox
.........o
oo........
oooo.....o
.....o.o..
....o..o..
..........
.....o....
.....o...o
.........o
o......o..
..........
..o.o..o.o
