9.ox
...o......o...
ooo..........o
.........o....
oo...o........
.........o....
........o.....
.x.o....o.o...
.....o....o...
......o...o...
