9.ox
....oo...o
.o.oo.....
o.....oo..
...o....oo
.o..o..o..
....o....o
.o........
....o.....
..o....o..
